1111111111101111
100000000000P001
111111111111EC11