111111111111111111111111111111111111111111111111111111111111111
111111111111111101010101000000000000000000000000000000000000001
1010101010100000000000000000000000000000000000000PPCCCC000E00001
111111111111111111111111111111111111111111111111111111111111111