111111111111111111111111111111111111111111111111111111111111111
111111111111111101010101000000000000000000000000000000000000001
10101010101000000000000000000000P0000000000000000000000EEE00001
111111111111111111111111111111111111111111111111111111111111111