111111111111111111111
1P1010000010000010001
101010101110111110111
100000101010001010101
101111101010101010101
101000000000100000101
101110101111101110101
100010100000100010001
111110111010101010101
100000001010101010101
111111101110101110111
101000001010101000101
101011111011101110101
100010100000001000001
101110111111111110111
100000100000101000001
101111101111101110111
100010000000101010101
101010111010101010101
101010100010000000CE1
111111111111111111111