1111111111111111111111111111111
1P0000000100100100000C000000001
1001111001001001111001111111001
1000001000000000000001000000001
1001001111001001111111001001001
1001001000001001000001001001001
1111001001111001001001111001111
10000010010000000010010000C0001
1111001001111111001111111111111
1000001001C00000001000001000001
1111001111111111001001111111001
1000000000001000000000001000001
1111001001001111001111111001001
1001001001000001000000001001001
1001111001111111001111111111001
1000001000001001000000000001001
1CC1111001001001111111001111001
1CC0000001001000000000000001001
1001001001111111001111001111001
1001001C010000000000010000000E1
1111111111111111111111111111111